1111111111111111111111111111111111111111
1000000000000000000000000000000000000001
1000000000000000000000000000000000000001
1000000000000011000000000000000000000001
1000000000000011000000000000000000000001
1000000010000011000000000000000000000001
1000000011111111111110000000000000000001
1000000000000001111111000000000000000001
1111111001111001111111100000000000000001
1111110000000001111111000000000000000001
1000100$01111111111110000000000000000001
1000110001100000000000000000000000000001
1001111111100000000000000000000000000001
1000000000000000000000000000000000000001
1111111111111111111111111111111111111111