1111111111111111111111111111111111111111
1000000000000000000000000000000000000001
1000000000000000000000000000000000000001
1000000000000000000000000000000000000001
1000000010000011000000000000000000000001
1000000010000011000000000000000000000001
1000000010000011000000000000000000000001
100000$010000011000000000000000000000001
1000000010000011000000000000000000000001
1000000010000011000000000000000000000001
1000111111111111111110000000000000000001
1000000010000011000000000000000000000001
1000000010000011000000000000000000000001
1000000000000000000000000000000000000001
1111111111111111111111111111111111111111