1111111111111111111111111111111111111111
1000000000000000000000000000000000000001
1000000000000000000000000000000000000001
1000000000000000000000000000000000000001
1000001111110011110000000000000000000001
1000000111100111110000000000000000000001
1000000111100111110000000000000000000001
1000000011001111110000000000000000000001
1001111110011111110000000000000000000001
1001111110111111110000000000000000000001
1111111111111111111110000000000000000001
1000000010000011000000000000$00000000001
1000000010000011000000000000000000000001
1000000000000000000000000000000000000001
1111111111111111111111111111111111111111